111111111111111111111111111
111111100000000000000000001
111111101111101101101111101
100000001111101101101111101
101111100000001101101111101
100000001111101100001111101
101101101111101111101111101
100000000000000000000000001
101111110111101111011111101
101000000111101111011111101
101010111111101111000000001
100010000000000111011111101
101111101111101111011111101
100000000000000000000000001
101111101111101110111110111
101111101111101110111110111
100000000000001110000000111
101101111110111110110111111
101101111110111110110111111
100000000000000000000000001
111111101111101111101111101
111111101111101111101111101
100000001110000000100000001
101111101110111110111110111
101111101110111110111110111
100000000000110000000000001
111111111111111111111111111