111111111111111111111111111
100000000000000000000000001
101111101111101111101111101
101111101111101111101111101
101111101111101111101111101
101111101111101111101111101
101111101111101111101111101
100000000000000000000000001
101111101111101111101111101
101111101111101111101111101
101111101111101111101111101
101111101111101111101111101
101111101111101111101111101
100000000000000000000000001
101111101111101111101111101
101111101111101111101111101
101111101111101111101111101
101111101111101111101111101
101111101111101111101111101
100000000000000000000000001
101111101111101111101111101
101111101111101111101111101
101111101111101111101111101
101111101111101111101111101
101111101111101111101111101
100000000000000000000000001
111111111111111111111111111