111111111111111111111111111
100000000000000000000000001
101111011111101111011111101
101111011111101111011111101
101100000000001111011111101
101101111101111111011100001
100001111101111111011101101
101100000001111111000001101
101111101111111111011111101
101111101111111111011111101
101111101111111111000000001
100000000000000000011101111
101111110111110111111101000
101111110111110111111101000
101111110111110111111101000
101111110000000000000001111
100000000111110111111100001
111110110111110111111101111
000010110111110111111101111
000010110000000111111101111
000010110111110111111101111
111110000111110111111101111
100000110111110000000000001
101111110111110111111111101
101111110111110111111111101
100000000000000000000000001
111111111111111111111111111